11111111111111
10010000000C01
10000111110011
1P0011E000C001
11111111111111