11111111111111
10C10000000001
100E0111110011
10P00000010001
1C000101010001
11111111111111