11111111111111
10C10000C00001
100E0111110011
10P00000C10001
1C0001C1C100C1
11111111111111