11111111111111
10010000C00001
100E0111110011
10P01100010001
11111111111111