1111111111111
1000010101001
110000000P001
10E0011100001
1000010000C01
1010010100001
1111111111111