1111111111111111
10C0C1000010C001
1C10001C00100001
1000PC000E000001
1C00F000C0000C01
1C00C00000F00001
1111111111111111