11111111111111
1C0100000000E1
11010111110011
10PC01C0C10001
1C000101010001
1000000CF00001
100F0000000C01
100C1101101111
1C001CC1C0C0C1
11111111111111