11111111111111
10C100000000E1
10000111110011
10PC01C0C10001
1C000101010001
100000C0000001
100F0000000C01
100C1100000011
1C001001001C01
11111111111111